11111111111111111
10000000000000001
1000000E000000001
100000C0000000001
10P00000000W00001
11111111111111111