
11111111111111111111111111111
10000000000000000000000000001
100000P000000010C000000000001
1000000000000E010000000000001
10000000000000100000000000001
11111111111111111111111111111