11111111111111111111111111111
10000000000000000000000000001
100000P000000000C000000000001
10000000000000000000000000001
1000000C0000000000000000000E1
11111111111111111111111111111