111111111111111111111111111111
10W0000000000000000000000000P1
10000000W000000000000000000001
100C00000E00000000000000000001
111111111110000000000000000001
100000000000000000000000000001
100000000000000000000000000001
100000000000000000000000000001
100000000000000000000000000001
100000000000000000000000000001
100000000000000000000000000001
100000000000000000000000000001
100000000000000000000000000001
100000000000000000000000000001
100000000000000000000000000001
111111111111111111111111111111
1