





111111111111111111
100000000000000011
100000000000000001
100000000000000001
111110C00000000011
10001E0P0000000011
100000000000000001
100000000000000001
10000000000W000001
100000000000000001
100000000000000001
100000000000000001
111111111111111111


