11111111111111111
1000W000000000001
1000000E000000001
111110C0000W00001
10P00000000000001
11111111111111111