111111111111111111111111111111
10W000000010000000000000000001
10000000W000000000000000000001
100C00000E10000000000000000001
111111111110000000000000000001
100000000000000000000000000001
1000000000000000000P0000000001
100000000000000000000000000001
100000000000000000000000000001
100000000000000000000000000001
100000000000000000000000000001
100000000000000000000000000001
100000000000000000000000000001
100000000000000000000000000001
100000000000000000000000000001
111111111111111111111111111111