111111111111111111111111
10W0000000000P0000000001
100C00000C00000000000001
111101111110000000000001
10C00E000000P00000000001
111111111111111111111111