11111111111
1000C000001
10000P00001
100000000E1
11111111111