111111111111111111111111
10W000000000000000000001
100C00000C00000000000001
111101111110000000P00001
10C00E000000000000000001
111111111111111111111111